WWWWWWWWWWWWWWWWWWWWWWWWWWWWWWWWWWWWWWWWWWWWWWWWWWWWWWWWWWW
WICCRCRRCCCIKCCCRCRCCRCCCIC CRCCCCKCRRRIRCKCCCRCCCRRCCCCCCW
WCRRCCCCCIRCKCCRCICCCRCCCCKCRCCCRCKCRCCCCCC CCCCCRCCRRCCRCW
WCCCMCRCCCRCKCCRCCRCRICCRRKCCCCCRCKCCCCCRCKCCRRCRCCCCCRCCCW
WCCCCCRCCCCCKCCRCRCCCCCCRRKKKCCCCCKCCCCRCCKRRCCCCCCCCCCRIRW
WCCCCCCCCRCCKCCCCCRRCCCCRCKRRICCCCKICCRCRCKCCCCKKKCKKKCRRRW
WCCICCCCRCCCKIRCCCCCC  RC CRRCCKKKKCRCCCRCKIICCKCC RCKCCCCW
WCCRRRRCCCCCKKKKKKKKKKKKKKKRICCKKKKCRCCCRCKKKKKKCCRCCKKKKKW
WCCRCCCCCCRCKCCRRIRCCKCCRCCRCCCKKKKCCRCCCCKICCCKCCCCCKIRRRW
WICCCCCCRCCCKCCCCCCRCC CRCCRCCCCCCKCCCCCCRKCCRRKRCRCRKRRERW
WRCCCCCCRCCCKCRCRCCCCKCCCRCRCKKKCCKCCCCRCCKCCCCKRCRCRKRRRRW
WCCCRICCCRCIKICCCCCICKIRRCCCCKKKCCKC CRCCIKCRCCKRCRCRKCCCCW
WKKCKKKCKKKKKRCCCCRRCKKCKKKKKKKKCCKKCKKKKKKCCCCKRCRCRKCCRCW
WICCCCC IKCCCCCCRCCCCKCIRCCCCCCCCCKCCCCCKCCCRCCKCCCCCKCRIRW
WCCCCRCCCKIIRCRCCCCCCKCCCCRRCCRCRCKCRCCCKRCCCC CCCCCCKCCCCW
WCCRCCCCCKCCCCCRCIC CKCCCCCCCCCCCIKCCCRCKRCCRCCKCCCCCKCCCRW
WCCICCRCCKKKKKKKKKKCKKKKKKKCKKKKKKKCCCCCKICRCCCKCCICCKCRCCW
WCCRCCCCRKCCCCCRCCCCRRCIKCC CRCCCCCCCCCRKCCCCCCKKKKKKKCCCRW
WCCCCICRCKRCCCCCRCCCCRRCKCCCCCRCCICCRCCCKCRCICCRCIKCRCCCCCW
WCCCRRCCCKCRCCRCCRCCCCCCKCRICCCCCCRCCCCRKCCCRCCCRCKCCRCCCRW
WCCCCRCCRC CRCCCRIRCCCRCKCCCCCCCRCCCCCCCKCCCCCCCCRC CCICRCW
WCRCCCCCCKCCCRCCRRCCCCRCKCCRCCCCRCCRRCRCKCCCCCRRCCKCCRRCCCW
WICCCRCCIKICCCRCCCCCCRCCKICCCCRCCCCCCCRIKICRCCCCCCKCRCCCCIW
WWWWWWWWWWWWWWWWWWWWWWWWWWWWWWWWWWWWWWWWWWWWWWWWWWWWWWWWWWW