WWWWWWWWWWWWWWWWWWWWWWWWWWWWWWWWWWWWWWWWWWWWWWWWWWWWWWWWWWWW
W                          K   K K K   K     K     K   K   W
WKKK KKKKKKKKKKKKKKKKKKKKK   K   K   K   K K   K K   K K K W
W        K K   K         KKKKKKK K KKKKKKKKKKKKK   K K   K W
W KKKKKKK  K K K KKKKKKK         K K   K   K   KKKKKKKKKKK W
W       K KK K K K     KKKKKKKKKKK K K K K   K K   K     K W
WKKKKKK K    K K K K K     K       K K K KKKKK K K K KKK K W
W     K K KKKK   K KKKKKKK   KKKKKKK K K   K   K K K K   K W
W KKK K K K   KKKK K   K KKKKK       K KKK K K   K   KKK W W
W   K K K KKK  K   K K K       KKKKKKK   K K KKKKKKKKK K   W
WKK K K K    K   KKK K   KKKKKKK     K K K K K       K K KKW
W   K   KKKK  KK   K KK KK       KKK K K K K K KKKKK K K   W
W KKKKKKK   K  KKK K  KKK  KKKKKKK   K K   K K K   K K KKK W
W     K K K  K K   KK  K  K      K KKKKKKKKK K K K K K   K W
WKKKK   K  K K K KK KK K K  KKKK K    K      K     K KKK K W
W   KKK KK K   K     K K K K   K K KK K KKKKKKKKKK K K   K W
W K K    K  KKKKKKKK K K K K K   K  K K    K     K KKK KKK W
W K K KKKKK        KKK K K K KKKKKK K KKKK K K K K   K   K W
W K K      KKKKK K     K K K K   K  K      K K K K K K K   W
W K KKKKKK K   K KKKKKKK K K   K K KKKKKKKKK K K K K KKKKK W
W K        K K K         K KKKKK K         K K K   K     KMW
W KKKKKKKKKK K KKKKKKKKKKK   K K KKKKKKKKKKK K KKKKKKK K KKW
W            K             K   K             K         K  EW
WWWWWWWWWWWWWWWWWWWWWWWWWWWWWWWWWWWWWWWWWWWWWWWWWWWWWWWWWWWW