WWWWWWWWWWWWWWWWWWWWWWWWWWWWWWWWWWWWWWWWWWWWWWWWWWWWWWWWWWWW
WIRCMCRIRCCCCCCRCCCCCCRCRCCCCCRCCRCRCCCCRCRCCCCRCRCCCCCRIRCW
WCCCCCCCCCCRCCCCRCRIRCCRCCCCCRCCCRCCRCCIRRCRCRCIRCCRCCCCCCCW
WCRCRCRIRCCCRRRCCRCRCCCRCCCCIRCCCCCCCRCRCCCCRCRCRCCICCCCCCCW
WIRCRCCRCCCRCCCRCCCCCRCRIRCCRCCCCCCRCRCCRCICCRCCCRCRCCCRRRCW
WRCCCRCCRRCRCRCIRCRCRRCCRIRCCCCCRCCCCRCRCRRRCRRCCRCCCCCRERCW
WCCRCCRICCCCCIRRCCCRCCCCCCCCCCCRIRIRCRCCRCCCRICRRICCCCCRRRCW
WCRICCCRRCRCRRCCCCCCICRCCRIRCRCCCCRCCRCCCCRCCRCRCCCCRRCCCCCW
WCCRCCCCCCIRCCRRCCRCCRIRCCCRCCCCCCCRCRCRCCRRRCCCCRCCCCCCCCCW
WRRRCCRCRRRCCCCCRICRCCCCCCCCCCCRIIRIRCRICRCCCCCCCCRCCCCCCRCW
WCCCCCCRICRCRIRCCRCCCCCCRRCCRCCCRRCCRCCCCRCRCCIRCCCCRRCCRICW
WCCRRCRCCCICCCCCRCCCCRCCCIRCRCCRCCCCCRCCCCCRCRRCCCCCRRCRIRCW
WCRIRCCRCRCCRRRRCCCCRIRCCCCCCCCCCCCCCCCRRCCCCCCCCRCCCCCCCRCW
WCCCCRCCRCCRRICCCCCRIRCRCCCCRCRRIRCRRCRIRCRRRCCCRIRCRRCCCRCW
WRCCRIRCRCRCCRCCRIRIRICCRCCCCIRCCCCCCCCRCCCIRCCCCCRCCCCRRCCW
WICRCRCCCCICCCRCCRCCCRCCCRCCCRICCCCRRRRCCRCCRCCRICRICCCCCRRW
WCCRCCCCRCRCCRCCRCCCCCRCCCCCCCRCRCRCCCRRRIRCCRCIRCCCRRCRCCIW
WCRCCCRCCCRCRCCRCCCCCCCRCCCCCCCCCCRCCRCCCCRCCCRCCCCCRRCRICRW
WCCCCIRRRCCCCCCCRRRCCCCRCCRCRCCRRCRCCIRCCCRCCCCRCCCCIICCRCRW
WRRCRRCCRRCCCRCCRICCCRCCCCCCCCRICCRRRTCCRCRCRCCRCCCCRRCCCCCW
WICCCCCRCRCRCCCCRCRCCIRRCCRCCCCRRCICCCCRICRIRCCRCCRCCCRCCCCW
WCCCRRCRCRCIRCCCCCCRCRICRCCCCCCCCCRCRIRCRCRCRCCRCCICRRIRKKKW
WKKKICCCCRCCCCCCCKIKCKKCCCCIKKCRCCKCKKKKCCKCKCCCCCRCIKCKKKKW
WWWWWWWWWWWWWWWWWWWWWWWWWWWWWWWWWWWWWWWWWWWWWWWWWWWWWWWWWWWW