WWWWWWWWWWWWWWW
W             W
W      RRR    W
W      CCC    W
W       R  X  W
W      RRR    W
W      CCC    W
W    E        W
W     CCCCC   W
W I           W
W    M KWK    W
W             W
W I    WWKKWW W
W      K    K W
W      W  X W W
WC     K    K W
W    C WWKKWW W
WC            W
W    C        W
W             W
WWWWWWWWWWWWWWW